8 8 8 8 8 8 8 8 8 8 8 8 8 8 8 8 8 8 8 8 8 8 8 8 8 8 8 8 8 8 8 8 8 8 8 8 8 8 8 8 8 8 8 8 8 8 8 8 8 8
8 8 8 8 8 8 8 8 8 8 8 8 8 8 8 8 8 8 8 8 8 8 8 8 8 8 8 8 8 8 8 8 8 8 8 8 8 8 8 8 8 8 8 8 8 8 8 8 8 8 
8 8 8 8 8 8 8 8 8 8 8 8 8 8 8 8 8 8 8 8 8 8 8 8 8 8 8 8 8 8 8 8 8 8 8 8 8 8 8 8 8 8 8 8 8 8 8 8 8 8 
8 8 8 8 8 8 8 8 8 8 8 8 8 8 8 8 8 8 8 8 8 8 8 8 8 8 8 8 8 8 8 8 8 8 8 8 8 8 8 8 8 8 8 8 8 8 8 8 8 8  
8 8 8 8 8 8 8 8 8 8 8 8 8 8 8 8 8 8 8 8 8 8 8 8 8 8 8 8 8 8 8 8 8 8 8 8 8 8 8 8 8 8 8 8 8 8 8 8 8 8 
8 8 8 8 8 8 8 8 8 8 8 8 8 8 8 8 8 8 8 8 8 8 8 8 8 8 8 8 8 8 8 8 8 8 8 8 8 8 8 8 8 8 8 8 8 8 8 8 8 8 
8 8 8 8 8 8 8 8 8 8 8 8 8 8 8 8 8 8 8 8 8 8 8 8 8 8 8 8 8 8 8 8 8 8 8 8 8 8 8 8 8 8 8 8 8 8 8 8 8 8
8 8 8 8 8 8 8 4 4 4 4 4 4 4 4 4 4 4 4 7 7 7 7 7 6 6 6 6 6 5 5 5 5 5 5 5 5 5 5 5 8 8 8 8 8 8 8 8 8 8
8 8 8 8 8 8 8 4 7 7 7 4 7 7 4 7 7 4 4 7 7 7 7 7 6 6 6 6 6 6 5 5 5 5 5 5 5 5 5 5 5 5 8 8 8 8 8 8 8 8
8 8 8 8 8 8 8 4 7 4 4 4 7 4 4 7 4 7 4 7 7 7 7 7 6 6 6 6 6 6 6 6 6 5 5 5 5 5 5 5 5 5 5 8 8 8 8 8 8 8
8 8 8 8 8 8 8 4 7 7 7 4 7 7 4 7 7 4 4 7 7 7 7 7 6 6 6 6 6 6 6 6 6 6 6 6 6 6 6 6 9 9 9 8 8 8 8 8 8 8
8 8 8 8 8 8 8 4 4 4 7 4 7 4 4 7 4 7 4 7 7 7 7 7 6 6 6 6 6 6 6 6 6 6 6 6 6 6 6 6 9 9 9 8 8 8 8 8 8 8
8 8 8 8 8 8 8 4 7 7 7 4 7 7 4 7 7 4 4 7 7 7 7 7 6 6 6 6 6 6 9 9 9 9 9 6 6 6 6 6 9 9 9 8 8 8 8 8 8 8
8 8 8 8 8 8 8 4 4 4 4 4 4 4 4 4 4 4 4 7 7 7 7 7 6 6 6 6 6 6 9 9 8 9 9 6 6 6 6 6 9 9 9 8 8 8 8 8 8 8
8 8 8 8 8 8 8 7 7 7 7 7 7 7 9 7 7 7 7 7 7 7 7 7 6 6 6 6 6 6 9 8 8 8 9 6 6 6 6 6 9 9 9 8 8 8 8 8 8 8
8 8 8 8 8 8 8 7 7 7 7 7 7 9 9 9 9 9 9 9 9 9 9 9 6 6 6 6 6 6 9 9 8 9 9 6 6 6 6 6 9 9 9 8 8 8 8 8 8 8
8 8 8 8 8 8 8 7 7 7 7 7 7 9 9 9 9 9 9 9 9 9 9 9 6 6 6 6 6 6 9 9 9 9 9 6 6 6 6 6 9 9 9 8 8 8 8 8 8 8
8 8 8 8 8 8 8 7 7 7 7 7 7 9 9 9 9 9 9 9 9 9 9 9 6 6 6 6 6 6 9 9 9 6 6 6 6 6 6 9 9 9 9 8 8 8 8 8 8 8
8 8 8 8 8 8 8 7 7 6 7 7 7 9 9 9 9 9 9 9 9 9 9 9 6 6 6 6 6 6 9 6 6 6 6 6 6 9 9 9 9 9 9 8 8 8 8 8 8 8
8 8 8 8 8 8 8 7 7 7 7 6 7 9 9 9 9 9 9 9 9 9 9 9 9 9 9 9 9 9 9 6 6 6 6 6 9 9 6 6 9 9 9 8 8 8 8 8 8 8
8 8 8 8 8 8 8 7 7 7 7 6 7 9 9 9 9 9 9 9 9 9 9 9 9 9 9 9 9 9 6 6 6 6 6 9 9 6 6 6 6 6 7 8 8 8 8 8 8 8
8 8 8 8 8 8 8 7 6 6 7 7 7 9 9 9 9 9 9 9 9 9 9 9 9 9 9 9 9 9 9 9 9 9 9 9 9 6 6 7 7 7 7 8 8 8 8 8 8 8
8 8 8 8 8 8 8 7 6 6 7 7 7 7 7 9 9 9 7 7 7 7 7 7 6 6 6 6 6 6 6 6 6 6 6 6 6 6 6 7 6 6 6 8 8 8 8 8 8 8
8 8 8 8 8 8 8 7 7 7 7 7 7 7 7 9 9 9 7 7 7 7 7 7 6 6 6 6 7 7 7 6 7 7 7 7 7 7 7 7 7 7 6 8 8 8 8 8 8 8
8 8 8 8 8 8 8 7 7 7 6 7 7 7 7 9 9 9 7 7 7 7 7 7 6 6 7 7 7 6 7 7 7 6 6 7 6 6 6 6 6 7 6 8 8 8 8 8 8 8
8 8 8 8 8 8 8 7 7 7 7 7 7 7 7 9 9 9 7 7 7 7 7 7 6 6 7 6 6 6 6 6 7 6 6 7 6 6 6 6 6 6 6 8 8 8 8 8 8 8
8 8 8 8 8 8 8 7 7 7 7 7 7 7 7 9 9 9 7 7 7 7 7 7 6 6 7 6 6 6 6 6 7 6 6 7 7 7 7 6 7 7 6 8 8 8 8 8 8 8
8 8 8 8 8 8 8 7 7 7 7 7 7 7 7 9 9 9 6 6 7 6 6 7 6 6 7 6 6 7 7 7 7 6 6 7 6 6 7 7 7 6 6 8 8 8 8 8 8 8
8 8 8 8 8 8 8 7 9 9 9 7 7 7 7 9 9 9 7 6 7 6 7 7 6 6 7 6 6 6 6 6 7 7 7 7 6 6 6 6 6 7 6 8 8 8 8 8 8 8
8 8 8 8 8 8 8 7 9 9 9 7 7 7 7 9 9 9 7 7 6 7 7 7 6 7 7 7 7 6 6 6 7 6 6 7 6 6 7 7 7 7 6 8 8 8 8 8 8 8
8 8 8 8 8 8 8 7 9 9 9 7 7 7 7 9 9 9 6 7 7 7 6 7 6 7 6 6 7 6 6 6 7 6 6 7 7 7 7 6 7 6 6 8 8 8 8 8 8 8
8 8 8 8 8 8 8 7 9 9 9 7 7 7 9 9 9 7 7 6 6 6 7 7 6 7 6 6 6 6 6 7 7 6 6 6 7 7 6 6 7 6 6 8 8 8 8 8 8 8
8 8 8 8 8 8 8 7 9 9 9 7 7 7 9 9 9 7 7 7 7 7 7 7 6 7 6 6 7 7 7 7 6 6 6 6 6 6 6 6 7 6 6 8 8 8 8 8 8 8
8 8 8 8 8 8 8 7 9 9 9 7 7 7 9 9 9 7 7 7 7 7 7 7 6 7 7 7 6 6 6 6 6 6 7 7 7 7 7 7 7 6 6 8 8 8 8 8 8 8
8 8 8 8 8 8 8 9 9 9 9 9 9 9 9 9 9 9 9 9 7 7 7 7 6 6 6 7 6 6 2 2 2 2 2 2 2 2 2 2 2 2 2 8 8 8 8 8 8 8
8 8 8 8 8 8 8 9 9 9 9 9 9 9 9 9 9 9 9 9 7 7 7 7 6 6 6 7 6 6 2 0 1 1 0 0 0 1 0 1 0 0 2 8 8 8 8 8 8 8
8 8 8 8 8 8 8 9 9 9 9 9 9 9 9 9 9 9 9 9 9 7 7 7 7 7 6 7 6 6 2 1 1 0 1 1 1 0 1 0 1 0 2 8 8 8 8 8 8 8
8 8 8 8 8 8 8 9 9 9 9 9 9 9 9 9 9 9 9 9 9 9 9 9 7 7 6 7 6 6 2 0 0 0 1 0 0 0 1 1 0 1 2 8 8 8 8 8 8 8
8 8 8 8 8 8 8 9 9 9 9 9 9 9 9 9 9 9 9 9 9 9 9 9 7 7 6 7 7 6 2 0 1 1 1 0 1 1 0 0 0 1 2 8 8 8 8 8 8 8
8 8 8 8 8 8 8 9 9 9 9 9 9 9 9 9 9 9 9 9 9 9 9 9 7 7 6 6 7 7 2 0 0 0 1 0 0 0 1 1 0 1 2 8 8 8 8 8 8 8
8 8 8 8 8 8 8 9 9 9 9 9 9 9 9 9 9 9 9 9 9 9 7 7 7 7 7 6 6 6 2 1 1 0 1 1 1 0 1 0 1 0 2 8 8 8 8 8 8 8
8 8 8 8 8 8 8 9 9 9 9 9 9 9 9 9 9 9 9 9 9 9 7 7 7 7 7 7 7 7 2 0 0 0 1 0 0 0 1 1 0 1 2 8 8 8 8 8 8 8
8 8 8 8 8 8 8 9 9 9 9 9 9 9 9 9 9 9 9 9 7 7 7 7 7 7 7 7 7 7 2 2 2 2 2 2 2 2 2 2 2 2 2 8 8 8 8 8 8 8
8 8 8 8 8 8 8 8 8 8 8 8 8 8 8 8 8 8 8 8 8 8 8 8 8 8 8 8 8 8 8 8 8 8 8 8 8 8 8 8 8 8 8 8 8 8 8 8 8 8
8 8 8 8 8 8 8 8 8 8 8 8 8 8 8 8 8 8 8 8 8 8 8 8 8 8 8 8 8 8 8 8 8 8 8 8 8 8 8 8 8 8 8 8 8 8 8 8 8 8
8 8 8 8 8 8 8 8 8 8 8 8 8 8 8 8 8 8 8 8 8 8 8 8 8 8 8 8 8 8 8 8 8 8 8 8 8 8 8 8 8 8 8 8 8 8 8 8 8 8
8 8 8 8 8 8 8 8 8 8 8 8 8 8 8 8 8 8 8 8 8 8 8 8 8 8 8 8 8 8 8 8 8 8 8 8 8 8 8 8 8 8 8 8 8 8 8 8 8 8
8 8 8 8 8 8 8 8 8 8 8 8 8 8 8 8 8 8 8 8 8 8 8 8 8 8 8 8 8 8 8 8 8 8 8 8 8 8 8 8 8 8 8 8 8 8 8 8 8 8
8 8 8 8 8 8 8 8 8 8 8 8 8 8 8 8 8 8 8 8 8 8 8 8 8 8 8 8 8 8 8 8 8 8 8 8 8 8 8 8 8 8 8 8 8 8 8 8 8 8
8 8 8 8 8 8 8 8 8 8 8 8 8 8 8 8 8 8 8 8 8 8 8 8 8 8 8 8 8 8 8 8 8 8 8 8 8 8 8 8 8 8 8 8 8 8 8 8 8 8